+---+--------------+
|   +---+          |
| + |   |          |
| B   B |          |
|DD+B+B++          |
|DPB   |           |
|DD  +-+           |
+----+             |
|                  |
|                  |
|                  |
|                  |
|                  |
|                  |
+------------------+