++--+--------------+
++  |              |
|  B|              |
++  ++             |
++B  |             |
|DBB |             |
|DDGC|             |
+----+             |
|                  |
|                  |
|                  |
|                  |
|                  |
|                  |
+------------------+