++----++-----------+
++    ++           |
++D++B |           |
| DDB  |           |
|  +B  |           |
|  P +-+           |
+----+             |
|                  |
|                  |
|                  |
|                  |
|                  |
|                  |
|                  |
+------------------+