+-+--+-------------+
| |  |             |
+-+B ++            |
|  G  |            |
|  G P|            |
|  G ++            |
+-+G |             |
| |D++             |
| +-+              |
|                  |
|                  |
|                  |
|                  |
|                  |
+------------------+