++---+-------------+
++ P +-+           |
++ +B  |           |
| GD D |           |
|  BB ++           |
+-+ +D|            |
| |   |            |
| +---+            |
|                  |
|                  |
|                  |
|                  |
|                  |
|                  |
+------------------+