+---+--------------+
|  P|              |
| BB| +-+          |
| B | |D|          |
+-+ +-+D|          |
+++    D|          |
||   |  |          |
||   +--+          |
++---+             |
|                  |
|                  |
|                  |
|                  |
|                  |
+------------------+