+-+-+--------------+
| |D|              |
| | |              |
| | +---+          |
+-+B B D|          |
|D BP+--+          |
+--+B|             |
|  |D|             |
|  +-+             |
|                  |
|                  |
|                  |
|                  |
|                  |
+------------------+