+----+-------------+
|P   |             |
| B  |             |
++G  |             |
| G ++             |
| G |              |
| G |              |
| D |              |
+---+              |
|                  |
|                  |
|                  |
|                  |
|                  |
+------------------+